111111
1000C1
10001
1P00E1
100001
100001
111111
