111111
1P0CE1
1CCC01
111111
 

