1111111
1P10001
10100E1
1C00001
1111111
       
