1111111
1P100C1
1C100C1
1E10001
1111111
