111111111
1000C01E1
100000101
1P00C0101
111111111
