1111111
10001E1
1000101
1P00C11
1111111
