1111111
1CC01C1
1000111
1P000E1
1111111
