11111111
10000001
1P000E11
101C1011
11111111
AAAAAAAA
