1111111111
    1P0001
    1CCCE1
1111111111
