11111111
1P000001
1CC000E1
11111111
