111111
1P0001
1C0001
1C0001
1CCCE1
111111
