11111
10001
1P001
1C0E1
11111
