111111111111111111111111111111
100000000000C00000000000000001
10000000000C0000C0000000000001
1000111000000000000000C0000001
10001C1000000000C0000000C00001
100010100000000000000000C00E01
100000C000000000C00000000C0001
101000000000000000000000000001
1P1000000000000000000000000001
111111111111111111111111111111
