1111111111111111111111111111111111111111111111
1P00000000000000000000000000000000000000000001
1000000000000000000000000000000000000000000001
1CCCCCCCCC000000000000000000000000000000000001
1000000000000000000CCCCCC000000000000000000001
1CCCCCCCCCCCC000000000000000000000000000000001
1000000000000000000000000000000000000000000001
1CCCCCCCCCCCCCCCCCCCCCCCCCCCCCCCCCCCCCCCCC0001
1000000000000000000000000000000000000000000001
1000000000000000000000000000000000000000000001
1000000000000000000000000000000000000000000001
1000000000000000000000000000000000000000000001
1CCC000000000000000000000000000000000000000001
1CCCCCC000000000000000000000000000000000000001
100000000CCCCCCCCC0000000000000000000000000001
1111111111111111110111111111111111111111111111
1111111111111111110111111111111111111111111111
1111111111111111110111111111111111111111111111
111111111111111111C111111111111111111111111111
1111111111111111100111111111111111111111111111
1111111111111111001111111111111111111111111111
1000000000000000000000000000000000000000000001
1000000000000000CCCC00000000000000000000000001
1000000000000000CC0000000000111111111111111111
1111111111111111101111111111111111111111111111
1111111111111111101111111111111111111111111111
11111111111111111E1111111111111111111111111111
1111111111111111111111111111111111111111111111
